3000000000
0000000000
0000000000
0011111000
0510001000
0510001000
0010001000
0000000000
0000000000
0000200000
