0101000000
0101000000
0100000000
0101111111
2101000000
0101001003
0001001000
0100001111
0101000000
0001000000
