0001000103
0101010100
0101010101
0101010100
0101010110
0101010100
0101010101
0101010100
0101010110
2100010000
