0000010103
0000010100
0001010101
0001010100
0001000110
2001110100
0001010001
0050010100
0011110110
0000010000
