0100010103
1000001000
0011010101
1100001000
0000000010
0101100100
1000010001
0000000100
1010010010
2000001000
