0000200000
0000000000
0000000000
0011111000
0010301000
0010001000
0010001000
0000000000
0000000000
0000000000
