0101000000
0101000000
0100000000
0101111111
3101000000
0101001002
0001001000
0100001111
0101000000
0001000000
