0000020000
0001001000
0101001010
0101111010
0100100010
0111111110
0000100000
0000100100
0000100100
0000130100
