0000000000
0001001000
0101001010
0101111010
0100100010
0111101110
0000100000
0000100100
0000100100
0002130100
